11
11
***********
*.........*
*.P.......*
*.........*
*.........*
*......E..*
*.........*
*.........*
*..E......*
*.........*
***********

