11
11
***********
*.........*
*.P.....T.*
*.........*
*.........*
*.T....E..*
*.........*
*.........*
*..E....T.*
*.........*
***********

